u g g g g g g g g 
g # # o # p # p g 
g # # # # # # # g 
g c # # # o # # g 
g # # # # # # # g 
g # # c # # # # g 
g g g g g g g g g 