u g g g g g g g g 
g p # o # o # v g 
g # # # # # # # g 
g p # # # c # v g 
g # # # # # # # g 
g c # # # # # # g 
g g g g g g g g g 