d g g g g g g g g 
g o # p # a # a g 
g # # # # # # # g 
g # # # # # # # g 
g # # # # # # # g 
g # # # # # # # g 
g g g g g g g g g 