u g g g g g g g g 
g c # o # o # p g 
g # # # # # # # g 
g # # # # # # # g 
g # # # # # # # g 
g # # # # c # p g 
g g g g g g g g g 